R 800 800
NO ./path_to_the_north_texture
SO ./path_to_the_south_texture
WE ./path_to_the_west_texture
EA ./path_to_the_east_texture
C 80,255,100
S ./path_to_the_sprite_texture
F 254,0,0




     11111
    1120211
    1020001
    1000001
    100001
    1200021
     12021
     10001
     12021
     11011                                11111111
 1111120211111111111111111111          11110000000111
12000000000000000000000000001       111000000000000011
10020000000000000000000001111      10000001000000000011
10000000000000000000000000000111111100000010000000000001
 11110000000000001111110000000000000000000000020000000201
    1000000000001   10000000000000000000000000000000000001
    1000000000011   1000000001111111000000000000000000011
    1000000S000001111000000111      1000000000000000001
 111000000000000000000000001         11000000000000011
1000000000000000100000111111           1110000000111
1000000111110000100001                    1100001
1000001     100000001       111111111111111100001
1000001     100000001       100000000020000000001
 11011       1111111        111111111111111111111
1111111