R 1920 1080
NO ./path_to_the_north_texture
SO ./path_to_the_south_texture
WE ./path_to_the_west_texture
EA ./path_to_the_east_texture

S ./path_to_the_sprite_texture
F 220,100,0
C 225,30,0

   11111111111111 111111111111
11100011000000000100000000000111
100000000000000001110000000001
10000011100000000011000000011
11000001000000000110000000001
10000111100000000110000000001
100011110000000001100000000111111111111
100000000000000000000000000S0000000001
111111110000000000000001000000000000001
        11111111111111111111111111111111
