R 900 900
NO ./path_to_the_north_texture
SO ./path_to_the_south_texture
WE ./path_to_the_west_texture
EA ./path_to_the_east_texture
C 0,0,0
S ./path_to_the_sprite_texture
F 254,0,0

      111
     12021
    1020001
    1000001
    100001
    1200021
     12021
     10001
     12021
     11011                                11111111
 1111120211111111111111111111          11110000000111
12000000000000000000000000001       111000000000000011
10020000000000000000000001111      10000000000000000011
10000000000000000000000000000111111100000000000000000001
 11110000000000001111110000000000000000000000020000000201
    1000000000001   10000000000000000000000000000000000001
    1000000000001   1000000001111111000000000000000000011
    10000000000001111000000111      1000000000000000001
 111000000000000000000000001         11000000000000011
1000000000000000100000111111           1110000000111
1000000111110000000001                    1100001
1000001     100000001       111111111111111100001
1000001     100000001       1000000000N0000000001
 11111       1111111        111111111111111111111