R 400 400
NO ./textures/mossy.xpm
SO ./textures/greystone.xpm
WE ./textures/colorstone.xpm
EA ./textures/bluestone.xpm
C 80,180,240
S ./path_to_the_sprite_texture
F 15,45,90



11111111111111111111111111111
10000000002000010000000000011
10011000000000010000000000001
10000100000100000000000000001
10000000000000010000000000011
10000000000000011111111111111
10000001100000001
10100S0000000001
1111111111111111