R 250 250
NO ./path_to_the_north_texture
SO ./path_to_the_south_texture
WE ./path_to_the_west_texture
EA ./path_to_the_east_texture
C 100,100,255
S ./path_to_the_sprite_texture
F 110,150,180



1111111111111111
1000000000200001
1001100000000001
1000000000010001
10000N0000000001
10000001100000001
1010000000000001
1111111111111111