# **************************************************************************** #
#                                                                              #
#                                                         :::      ::::::::    #
#    map.cub                                            :+:      :+:    :+:    #
#                                                     +:+ +:+         +:+      #
#    By: lfourmau <marvin@42.fr>                    +#+  +:+       +#+         #
#                                                 +#+#+#+#+#+   +#+            #
#    Created: 2021/02/16 09:05:47 by lfourmau          #+#    #+#              #
#    Updated: 2021/02/22 15:02:46 by lfourmau         ###   ########lyon.fr    #
#                                                                              #
# **************************************************************************** #

R 1920 1080
NO ./path_to_the_north_texture
SO ./path_to_the_south_texture
WE ./path_to_the_west_texture
EA ./path_to_the_east_texture

S ./path_to_the_sprite_texture
F 220,100,0
C 225,30,0

     1111111111111111111111111
111111000000000000000000000001
100000000000000001110000000001
100000111000000000110000000001
110000010000000000110000000001
100001111000000000110000000001
1000111100000000011000000000111111111111
1000000000000000000000000000000000000001
1111111100000000000000000000000000000001
       111111111111111111111111111111111
