R 1920 1080
NO ./path_to_the_north_texture
SO ./path_to_the_south_texture
WE ./path_to_the_west_texture
EA ./path_to_the_east_texture

S ./path_to_the_sprite_texture
F 220,100,0
C 225,30,0

   1  1111111111111111111111111
111011000000000000000000000111
100000000000000001110000000001
10000011100000000011000000011
110000010000000000110000000001
100001111000000000110000000001
1000111100000000011000000000111111111111
100000000000000000000000E00000000000001
11111111000000000000000100000000000000001
        11111111111111111111111111111111
