R 1920 1080
NO ./path_to_the_north_texture
SO ./path_to_the_south_texture
WE ./path_to_the_west_texture
EA ./path_to_the_east_texture


S ./path_to_the_sprite_texture
F 220,100,0
C 255,230,0

      111
     12021
    1020001
    1000001
    100001
    1200021
     12021
     10001
     12021
     10001                                1111111
 111112021111111111111111111           1110000000111
10000000000000000000000000001        11000000000000011
10020000000000000000000000111       1000000000000000001
10000000000000000000000000000111111100000000000000000001
 111100000000000011111100000000000000000000000200000S0201
    1000000000001   1000000000000000000000000000000000001
    1000000000001   100000000111111100000000000000000001
    10000000000001111000000111      1000000000000000001
 111000000000000000000000001         11000000000000011
1000000000000000100000111111           1110000000111
1000000111110000000001                    1100001
1000001     100000001       111111111111111100001
1000001     100000001       100000000000000000001
 11111       1111111        111111111111111111111
