R 1080 1080
NO ./textures/minecraft3.xpm
SO ./textures/minecraft2.xpm
WE ./textures/minecraftwood.xpm
EA ./textures/wood.xpm
S  ./textures/pikapika.xpm
C  56,206,224
F  113,67,32

11111111111111111111111111111
101000000000000100000111001111111111111111111111
100110200000001000000000000300000000100000000001
100002220001000000000000100030000000300000000001
102002220000000100001000101111102020100002000001
1000222220000000111111331011111111000300000000001
10100001100000111111000000000030000010000N000001
10100000000000003300000000011111111111100000111111
131111111111111111110000000000000000111111111111
13000000000000000000000000000000000001
1111111111111111111111111111111111111