R 1080 1080
NO ./textures/bluestone.xpm
SO ./textures/colorstone.xpm
WE ./textures/eagle.xpm
EA ./textures/redbrick.xpm
S ./textures/barrel_sprite.xpm
C 56,206,255

F 113,67,32

111111111111111111111111111111111111111111
100000000000000000000000000000000000000001
100000000000000000000000000000000000000001
100000000000000002202220000000000000000001
10000000000000000000000000000000000000000111111111111111111111111111111111111111111111111111111111
100000000000000000000000000000000000000000000000000000000000000002000000000000000000001100000000001
1000000000000000000000000100000000001000000000020000000000000000000000000000000000000003000000000001
10000000000000000N000000010000000000100000000000000000000000000000000000000000000000001100000000001
10000000000000000000000000000000000000000111111111111111111111111111111111111111111111111111111111
100000000000000000000000000000000000000001
100000000000000000000000000000000000000001
100000110000000000000000000000000000000001
100000000000000000000000000000000000000001
100000000000000000000020000000000000000001
100000000000000000000000000000000000000001
111111111111111111111111111111111111111111