R 1200 1200
NO ./textures/minecraft3.xpm
SO ./textures/minecraft2.xpm
WE ./textures/minecraftwood.xpm
EA ./textures/wood.xpm
C  56,206,224
S ./path_to_the_sprite_texture
F 113,67,32



11111111111111111111111111111
10100000002000010000000000011
10011020000000010000000000001
10000100000100000000000000001
10000000000000010000000000011
1000000000000001111113311111111
10000001100000111111000010000001
110100E000000000011000000000111111111
1111111111111111111100000000000000001
11111111111111111111000000000000000001
 111111111111111111111111111111111111