R 1400 1080
NO ./textures/manon.xpm
SO ./textures/adam.xpm
WE ./textures/simon.xpm
EA ./textures/philou.xpm
S  ./textures/barrel_sprite.xpm
C  56,206,224
F  113,67,32

11111111111011111111111111111
10100000000000010000011110111111111111111111111
1001102000000010000000000003000000001000000000011
10000222000100000000000010003000000030000000000021
1020022200000001000010001011111020201000020000011
1E00222220000000111111331011111111000000000000001
1010100100000011111100000 00000300000100000000001
10100000000000003300000000011111111111100000111111
131111111111111111110000000000000000111111111111
13000000000000000000000000000000000001
1111111111111111111111111111111111111