R 1080 1080
NO ./textures/minecraft3.xpm
SO ./textures/minecraft2.xpm
WE ./textures/minecraftwood.xpm
EA ./textures/wood.xpm
S  ./textures/barrel_sprite.xpm
C  56,206,224
F  113,67,32

11111111111111111111111111111
10100000000000010000011100111111111111111111111
100110200000001000000000000300000000100000000001
10E0022200010000000000001000300000003000000000021
102002220000000100001000101111102020100002000001
1000222220000000111111331011111111000300000000001
101000011000001111110000000000300000100000000001
10100000000000003300000000011111111111100000111111
131111111111111111110000000000000000111111111111
13000000000000000000000000000000000001
1111111111111111111111111111111111111