R 1080 1080
NO ./textures/minecraft3.xpm
SO ./textures/minecraft2.xpm
WE ./textures/minecraftwood.xpm
EA ./textures/wood.xpm
C  56,206,224
S ./textures/pikapika.xpm
F 113,67,32



11111111111111111111111111111
10100000000000010000011100111111111
100110200000001000000000000300000011
1000010000010000000000N01000300000001
1020000000000001000010001011111020201
1000000200000001111113310111111110001
1010000110000011111100000000003000001
101000000000000033000000000111111111
1311111111111111111100000000000000001
13000000000000000000000000000000000001
1111111111111111111111111111111111111