R 1200 1200
NO ./textures/minecraft3.xpm
SO ./textures/minecraft2.xpm
WE ./textures/minecraftwood.xpm
EA ./textures/wood.xpm
C  56,206,224
S ./textures/barrel_sprite.xpm
F 113,67,32



11111111111111111111111111111
10100000002000010000000000011111111
100110200000000100000000000030000001
1000010000010000000000000000300000001
1000000000000001000000000001111020201
1000002000000001111113311111111000001
1000000110000011111100001000003000001
100100E000000000033000000000111111111
1011111111111111111100000000000000001
13000000000000000000000000000000000001
 111111111111111111111111111111111111