

R 1080 1080
NO ./textures/manon.xpm
SO ./textures/adam.xpm
WE ./textures/simon.xpm
EA ./textures/philou.xpm
S ./textures/pikapika.xpm
C 56,206,224

F 113,67,32

1111
1S111111111111111111111111111
13100000000000010000011110111111111111111111111
1301102000000010000000000003000000001000000000011
13000222000100000000000010003000000030000000000021
1320022200000001000010001011111020201000020000011
1333222220000000111111331011111111000000000000001
131010010000001111110000000000300000100000000001
13100000000000003000000000011111111111100000111111
131111111111111111110000000000000000111111111111
13000000000000000000000000000000000001
1111111111111111111111111111111111111