R 1400 1080
NO ./textures/simon.xpm
SO ./textures/adam.xpm
WE ./textures/manon.xpm
EA ./textures/philou.xpm
S ./textures/barrel_sprite.xpm
C  56,206,224
F  113,67,32

111111111111111111111111111111111111
122222222222222222222222222222222221
122222222222222222222222222222222221
122222222222222222222222222222222221
122222222222222222222222222222222221
122222222222222222222222222222222221
122222222222222222222222222222222221
122222222222222222222222222222222221
122222222222222222222222222222222221
122222222222222222222222222222222221
1222222222222222N2222222222222222221
122222222222222222222222222222222221
122222222222222222222222222222222221
122222222222222222222222222222222221
122222222222222222222222222222222221
122222222222222222222222222222222221
122222222222222222222222222222222221
122222222222222222222222222222222221
122222222222222222222222222222222221
111111111111111111111111111111111111