R 1400 1080
NO ./textures/simon.xpm
SO ./textures/adam.xpm
WE ./textures/manon.xpm
EA ./textures/philou.xpm
S ./textures/pikapika.xpm
C  56,206,224
F  113,67,32
11111111111111111111111111111111111111111111111111111111111
10000000000000000000000000000000000000000000000000000000001
10000000000000000000000000000000000000000000000000000000001
10000000000000000000000000000000000000000000000000000000001
10002222222222222222222222222222222222000000000000000000221
10000000000000000000000000000000000000000000000000000000001
10000000000000000000000000000000000000000000000000000000001
10000000000000000000000000000000000000200000000000000000001
10000000000000000000000000002000000000000000000000000000001
10000000000000000000000000000000000000000000000000000000001
100000000000000000000000002000000000S0000000000020000000001
10000000000000000000000000000000000000000000000000000000001
10000000000000000000000000000000000000002000000000000000001
10000000000000000000000200000000000000000000000000000000001
100000000000000000000000000000000020000000000000000000000001
10000000000000000000000000000000000000000000000000000000001
10000000000000000000000000000000000000000000000000000000001
10022222222222222222222200000000000000000000000000222222221
10000000000000000000000000000000000000000000000000000000001
10000000000000000000000000000000000000000000000000000000001
10000000000000000000000000000000000000000000000000000000001
1111111111111111111111111111111111111111111111111111111111111111111111111111111111