R 1200 1200
NO ./textures/tnt3.xpm
SO ./textures/tnt2.xpm
WE ./textures/tnt1.xpm
EA ./textures/minecraft1.xpm
C  56,206,224
S ./path_to_the_sprite_texture
F 113,67,32



111111111111111111111111
100000000000001100000001
11111111100000000000111111111
10000000000000001000000000001
10000000011111000000000000001
10000000000001000000000000001
10000N00000000000000111000101
11111111111111111111111111111