R 1200 1200
NO ./textures/pack3.xpm
SO ./textures/pack2.xpm
WE ./textures/pack1.xpm
EA ./textures/pack4.xpm
C  56,206,224
S ./path_to_the_sprite_texture
F 113,67,32



111111111111111111111111
100000000000001100000001
11111111100000000000111111111
10000000000000001000000000001
10000000011111000000000000001
10000000000001000001111111111111
100001111000000000000000000000001
100001000000000000000000000000001
100000000000000000000000000000001
11111000000000S00000000000000001
1111111111111111111111111111111