R 1200 1200
NO ./textures/minecraftlib.xpm
SO ./textures/commandblock.xpm
WE ./textures/crafttable.xpm
EA ./textures/purplestone.xpm
C  56,206,224
S ./path_to_the_sprite_texture
F 113,67,32



111111111111111111111111
100000000000001100000001
11111111100000000000111111111
10000000000000001000000000001
10000000011111000000000000001
10000000000001000001111111111111
11111111111111111001
111111111111111100011
111111111111111000000111111111
11100000000000000000000000001
1000000000000000000E000000001
1000000000000000000000000001
111111111111111111111111111